24 13
########################
#...e...........e......#
#.....#####..######....#
#.#...#...#..#....#..y.#
#.#...#....#.....e.....#
#.....#....####....#####
#..e....####....#......#
#.k.#......e.......y...#
#...#...........@......#
####..#..######....#####
#.e...#.....y...e......#
#.....##########.......#
########################
