24 13
########################
#...e...........e......#
#.....#####..######....#
#.#...#...#..#....#....#
#.#...#....#.....e.....#
#.....#....####....#####
#..e....####....#......#
#.k.#......e...........#
#...#...........@......#
####..#..######....#####
#.e...#.........e......#
#.....##########.......#
########################
