30 15
##############################
#..........e.................#
#..######.....e.......####...#
#..#....#.............#  #.k.#
#..#....#........y....#  #...#
#..#....###.##############...#
#..#.....k...#  #.......#...#
#..#.e.......#  #.......#...#
#..######################...#
#................e..........#
#........e...............y..#
#####...###############..####
    #...#             #..#
    #.@.#             #..#
    #####             ####