30 15
##############################
#..........e.................#
#..######.....e.......####...#
#..#....#.............#  #.k.#
#..#....#.............#  #...#
#..#....###.##############...#
#..#.....k...#  #.......#...#
#..#.e.......#  #.......#...#
#..######################...#
#................e..........#
#........e..................#
#####...###############..####
    #...#             #..#
    #.@.#             #..#
    #####             ####