20 15
####################
#......e..........#
#...######..e.....#
#...#....#........#
#...#....#....k...#
#..e#....#........#
#...######........#
#................@#
####..#####..######
   #..#   #..#
   #..#   #..#
   #..#   #..#
  ##..## ##..##
  #......#....#
  ##############
