30 16
##############################
#...e..........#............#
#..e....#######..#..####....#
#.....#.........#..#....e...#
#.....#....#....#..#..#.....#
#..####....#....#..#..#.....#
#..#.......#....#..#..#.....#
#..#..#....#....#..#...e....#
#....###....@.....####......#
#....####....#..#.....e.....#
#....#..#....#..#...#.......#
#.....##.....#....#....k....#
#...........#..#..###.......#
#....#.......#..............#
##############################
