30 15
##############################
#...e..........#............#
#..e....#######..#..####....#
#.....#....y....#..#....e...#
#.....#....#....#..#..#.....#
#..####....#....#..#..#.....#
#..#.......#....#..#..#.....#
#..#..#....#....#..#...e....#
#....###....@.....####......#
#....####....#..#.....e.....#
#....#..#....#..#...#.......#
#.....##.y...#....#....k....#
#...........#..#..###.......#
#....#.......#..............#
##############################