22 14
######################
#...e..........e.....#
#....######.....######
#..e.#....#.....#....#
#....#....#.....#....#
#....####.#.....#....#
#..e....#.#...####....#
#..####.#.#.......#...#
#........#..@......e..#
#......k.#..e.......##
#....e..#..#.........#
#....#....###..#####..#
######################
