22 13
######################
#k..e..........e.....#
#....######.....######
#..e.#....#.....#....#
#....#....#.....#....#
#....####.#.....#....#
#..e....#.#...####....#
#..####.#.#.......#...#
#........#..@......e..#
#......y.#..e.......##
#....e..#..#.........#
#....#....###..#####..#
######################