25 22
#########################
#.........e............#
#.....#######....####..#
#.....#     #....#  #..#
#..e..#     #....#  #..#
#.....#     #....#  #..#
#####.#     ######  #..#
    #.#       #....#..#
    #.#       #....#..#
    #.#       ######..#
  ###.####   #.......k#
  #......#   #........#
  #......#   #........#
  #......#   ######..##
  #..@...#        #..#
  #......#        #..#
  #......#        #..#
  ####.###        ####
     #.#
     #.#
     ###
