25 21
#########################
#.........e............#
#.....#######....####..#
#.....#     #....#  #..#
#..e..#     #e...#  #..#
#.....#     #....#  #..#
#####.#     #########..#
    #.#       #....#..#
    #e#       #.k..#..#
    #.#       ###.##..#
  ###.####   #........#
  #......#   #....e...#
  #......#   #........#
  #......#   ######..##
  #..@...#        #..#
  #......#        #..#
  #......#        #..#
  ####.###        ####
     #.#
     #.#
     ###